OOOOOOOOOOO
OOXXXOOOOOO
OOXBXOOOOOO
OOXGXOOOOOO
OOXOXOOOOOO
OOXOXXXXOOO
OOXOOOEXOOO
OOXOXXXXOOO
OOXOXOOOOOO
OOXPXOOOOOO
OOXWXOOOOOO