OOOOOOOOO
OOXXXOOOO
OOXBXOOOO
OOXGXOOOO
OOXOXOOOO
OOXOXXXXO
OOXOOOEXO
OOXOXXXXO
OOXOXOOOO
OOXPXOOOO
OOXWXOOOO